"a" = (/obj/machinery/power/shuttle_engine/heater,/obj/structure/window/reinforced{dir = 4},/obj/effect/turf_decal/stripes/line,/obj/structure/window/reinforced{dir = 8},/turf/open/floor/plating/airless,/area/space)
"e" = (/obj/item/folder/red,/obj/item/restraints/handcuffs,/obj/structure/table/reinforced,/turf/open/floor/mineral/plastitanium,/area/space)
"h" = (/obj/machinery/button/flasher{id = "gulagshuttleflasher"; name = "Flash Control"; pixel_y = -26; req_access = list("security")},/obj/effect/turf_decal/trimline/red/line,/obj/machinery/light/dim/directional/south,/turf/open/floor/mineral/plastitanium,/area/space)
"j" = (/obj/machinery/door/airlock/shuttle{id_tag = "prisonshuttle"; name = "Prison Shuttle Airlock"},/obj/effect/turf_decal/stripes/line,/obj/effect/mapping_helpers/airlock/access/all/security/brig,/obj/effect/turf_decal/trimline/red/filled/warning,/obj/effect/turf_decal/trimline/red/filled/warning{dir = 1},/turf/open/floor/mineral/plastitanium,/area/space)
"l" = (/obj/machinery/door/airlock/shuttle{id_tag = "prisonshuttle"; name = "Labor Shuttle Airlock"},/obj/effect/turf_decal/stripes/line{dir = 8},/obj/effect/turf_decal/stripes/line{dir = 4},/turf/open/floor/iron/smooth,/area/space)
"m" = (/obj/effect/turf_decal/trimline/red/line{dir = 4},/obj/structure/chair/comfy/shuttle{dir = 1},/turf/open/floor/mineral/plastitanium,/area/space)
"n" = (/obj/effect/turf_decal/stripes/line{dir = 6},/obj/effect/turf_decal/trimline/red/filled/line{dir = 6},/obj/structure/chair/comfy/shuttle{dir = 8},/turf/open/floor/iron/textured,/area/space)
"o" = (/obj/structure/chair/comfy/shuttle{dir = 4},/obj/effect/turf_decal/trimline/red/filled/line{dir = 8},/obj/effect/turf_decal/stripes/line{dir = 8},/turf/open/floor/iron/textured,/area/space)
"p" = (/obj/machinery/computer/shuttle/prison{dir = 4; shuttleId = "prison"},/obj/structure/reagent_dispensers/wall/peppertank/directional/west,/obj/effect/turf_decal/bot,/turf/open/floor/mineral/plastitanium,/area/space)
"q" = (/turf/open/floor/iron/textured,/area/space)
"t" = (/obj/effect/turf_decal/stripes/line{dir = 10},/obj/effect/turf_decal/trimline/red/filled/line{dir = 10},/obj/structure/chair/comfy/shuttle{dir = 4},/obj/machinery/flasher/directional/west{id = "gulagshuttleflasher"},/turf/open/floor/iron/textured,/area/space)
"u" = (/obj/effect/turf_decal/bot,/turf/open/floor/iron/smooth,/area/space)
"y" = (/turf/closed/wall/mineral/titanium,/area/space)
"z" = (/obj/effect/turf_decal/stripes/line,/obj/effect/decal/cleanable/dirt,/obj/effect/turf_decal/trimline/red/filled/warning{dir = 1},/turf/closed/wall/mineral/titanium/nodiagonal,/area/space)
"A" = (/obj/effect/spawner/structure/window/reinforced/shuttle,/turf/open/floor/plating,/area/space)
"B" = (/obj/machinery/mineral/stacking_unit_console{pixel_x = 30; pixel_y = 30},/obj/effect/turf_decal/tile/red/half{dir = 4},/turf/open/floor/mineral/plastitanium,/area/space)
"C" = (/obj/machinery/power/shuttle_engine/propulsion,/obj/effect/turf_decal/stripes/line,/obj/structure/window/reinforced{dir = 8},/obj/structure/window/reinforced{dir = 4},/turf/open/floor/plating/airless,/area/space)
"E" = (/obj/effect/turf_decal/trimline/red/filled/line{dir = 9},/obj/effect/turf_decal/stripes/line{dir = 9},/obj/structure/chair/comfy/shuttle{dir = 4},/obj/machinery/light/dim/directional/north,/turf/open/floor/iron/textured,/area/space)
"F" = (/obj/effect/turf_decal/trimline/red/line{dir = 6},/turf/open/floor/mineral/plastitanium,/area/space)
"G" = (/obj/effect/turf_decal/delivery,/obj/structure/closet/crate,/turf/open/floor/iron/smooth,/area/space)
"L" = (/obj/effect/turf_decal/stripes/line,/obj/effect/turf_decal/trimline/red/filled/line,/turf/open/floor/iron/textured,/area/space)
"M" = (/obj/effect/turf_decal/loading_area{dir = 4},/turf/open/floor/iron/smooth,/area/space)
"N" = (/turf/closed/wall/mineral/plastitanium/nodiagonal,/area/space)
"O" = (/obj/machinery/power/shuttle_engine/heater,/obj/structure/window/reinforced{dir = 8},/obj/effect/turf_decal/stripes/line,/obj/structure/window/reinforced{dir = 4},/turf/open/floor/plating/airless,/area/space)
"P" = (/turf/closed/wall/mineral/titanium/nodiagonal,/area/space)
"Q" = (/obj/effect/decal/cleanable/dirt,/obj/structure/chair/comfy/shuttle{dir = 8},/obj/effect/turf_decal/trimline/red/filled/line{dir = 5},/obj/effect/turf_decal/stripes/line{dir = 5},/obj/effect/turf_decal/arrows{dir = 1; pixel_x = -7; pixel_y = -8},/obj/effect/turf_decal/arrows{dir = 1; pixel_x = 7; pixel_y = -8},/turf/open/floor/iron/textured,/area/space)
"R" = (/obj/machinery/power/shuttle_engine/propulsion,/obj/effect/turf_decal/stripes/line,/obj/structure/window/reinforced{dir = 4},/obj/structure/window/reinforced{dir = 8},/turf/open/floor/plating/airless,/area/space)
"U" = (/obj/structure/chair/comfy/shuttle{dir = 8},/obj/machinery/flasher/directional/east{id = "gulagshuttleflasher"},/obj/effect/turf_decal/trimline/red/filled/line{dir = 4},/obj/effect/turf_decal/stripes/line{dir = 4},/turf/open/floor/iron/textured,/area/space)
"V" = (/obj/machinery/door/airlock/shuttle{id_tag = "prisonshuttle"; name = "Prison Shuttle Airlock"},/obj/docking_port/mobile{shuttle_id = "seleneprison"; name = "selene prison"},/obj/effect/mapping_helpers/airlock/access/all/security/brig,/turf/open/floor/iron/smooth,/area/space)
"Y" = (/obj/effect/turf_decal/trimline/red/filled/line{dir = 1},/obj/effect/turf_decal/stripes/line{dir = 1},/turf/open/floor/iron/textured,/area/space)

(1,1,1) = {"
yAAAy
ypmey
AhFBA
yPjzy
yEYQy
AoqUy
ytLnl
OGMua
CNVNR
"}
